aa	@aa\n- (Alcoholics Anonymous) Hội cai rượu\n- (Automobile Association) Hội ô tô\n@Chuyên ngành kỹ thuật\n@Lĩnh vực: điện lạnh\n-abampe\n@Lĩnh vực: điện\n-ampe hệ từ
aardvark	@aardvark\n* danh từ\n- (động vật) lợn đất
aardwolf	@aardwolf\n* danh từ\n- <động> chó sói đất (Nam Phi)
aasvogel	@aasvogel /'ɑ:sfougəl/\n*  danh từ\n- (động vật học) con kên kên (Nam Phi)
ab	@ab\n- (vt của able-bodied seaman) thủy thủ hạng nhất\n- (vt của Bachelor of Arts) Cử nhân văn chương
aba	@aba /'ɑ:bə/\n*  danh từ\n- áo aba (áo ngoài giống hình cái túi người A-Rập)
abaca	@abaca\n* danh từ\n- vải dệt bằng tơ chuối abaca ở philipin\n- cây chuối abaca
abaci	@abaci /'æbəkəs/\n*  danh từ,  số nhiều abaci,  abacuses\n- bàn tính\n=to move counters of an abacus; to work an abacus+ tính bằng bàn tính, gảy bàn tính\n- (kiến trúc)\n- đầu cột, đỉnh cột\n@Chuyên ngành kỹ thuật\n-bản đồ tính\n-bàn tính\n-toán đồ
aback	@aback /ə'bæk/\n*  phó từ\n- lùi lại, trở lại phía sau\n=to stand aback from+ đứng lùi lại để tránh\n- (hàng hải) bị thổi ép vào cột buồm (buồm)\n=to be taken aback+ (hàng hải) bị gió thổi ép vào cột buồm\n- (nghĩa bóng) sửng sốt, ngạc nhiên\n=to be taken aback by the news+ sửng sốt vì cái tin đó\n@Chuyên ngành kỹ thuật\n-lùi lại
abacterial	@abacterial\n* tính từ\n- không do vi khuẩn gây ra\n@Chuyên ngành kỹ thuật\n@Lĩnh vực: y học\n-không có vi khuẩn\n-không do vi khuẩn gây nên
abacus	@abacus /'æbəkəs/\n*  danh từ,  số nhiều abaci,  abacuses\n- bàn tính\n=to move counters of an abacus; to work an abacus+ tính bằng bàn tính, gảy bàn tính\n- (kiến trúc)\n- đầu cột, đỉnh cột\n@Chuyên ngành kinh tế\n-bàn tính\n@Chuyên ngành kỹ thuật\n-bản đồ tính\n-bàn tính\n-bảng tính\n-đầu cọc\n-đầu cột\n-đỉnh cột\n-mũ cột\n-tấm đỉnh\n@Lĩnh vực: xây dựng\n-bài toán\n-đệm đầu cột\n-mũ đệm
abaft	@abaft /ə'bɑ:ft/\n*  phó từ\n- (hàng hải) ở phía sau bánh lái, gần phía bánh lái\n*  giới từ\n- (hàng hải) sau, ở đằng sau, ở phía sau\n=abaft the mast+ sau cột buồm\n@Chuyên ngành kỹ thuật\n-về phía sau\n@Lĩnh vực: giao thông & vận tải\n-ở phía sau (tàu)
abalone	@abalone /,æbə'louni/\n*  danh từ\n- (từ Mỹ,nghĩa Mỹ) bào ngư
abampere	@abampere\n- (Tech) abampe, ampe tuyệt đối (đơn vị cường độ tuyệt đối của dòng điện, 1 abampe = 10 ampe)\n@Chuyên ngành kỹ thuật\n@Lĩnh vực: đo lường & điều khiển\n-aA (ampe hệ CGS điện từ, 10 ampe)\n@Lĩnh vực: điện\n-ampe hệ từ
abandon	@abandon /ə'bændən/\n*  ngoại động từ\n- bộm (nhiếp ảnh) (nhiếp ảnh) (từ Mỹ,nghĩa Mỹ) từ bỏ; bỏ rơi, ruồng bỏ\n=to abandon a hope+ từ bỏ hy vọng\n=to abandon one's wife and children+ ruồng bỏ vợ con\n=to abandon oneself to+ đắm đuối, chìm đắm vào (nỗi thất vọng...)\n*  danh từ\n- sự phóng túng, sự tự do, sự buông thả\n=with abandon+ phóng túng\n@Chuyên ngành kinh tế\n-bỏ phế\n-từ bỏ\n@Chuyên ngành kỹ thuật\n-bỏ\n-bỏ cuộc (đăng ký)\n-bỏ đi\n-bỏ hoang\n-loại bỏ\n-vứt bỏ\n-xóa bỏ
abandoned	@abandoned /ə'bændənd/\n*  tính từ\n- bị bỏ rơi, bị ruồng bỏ\n- phóng đãng, truỵ lạc\n@Chuyên ngành kỹ thuật\n@Lĩnh vực: hóa học & vật liệu\n-bị bỏ\n-bị từ bỏ\n@Lĩnh vực: toán & tin\n-bị hủy bỏ
abandoner	@abandoner /ə'bændənə/\n*  danh từ\n- (pháp lý) người rút đơn\n@Chuyên ngành kinh tế\n-người bỏ của\n-người giao phó
abandonment	@abandonment /ə'bændənmənt/\n*  danh từ\n- sự bỏ, sự từ bỏ, sự bỏ rơi, sự ruồng bỏ\n- tình trạng bị bỏ rơi, tình trạng bị ruồng bỏ\n- sự phóng túng, sự tự do, sự buông thả\n@Chuyên ngành kinh tế\n-bỏ phế\n-sự giao phó (hàng hóa tổn thất cho công ty bảo hiểm)\n@Chuyên ngành kỹ thuật\n-bỏ\n-sự bỏ\n-sự hủy bỏ\n-sự loại bỏ\n@Lĩnh vực: hóa học & vật liệu\n-từ bỏ
abandonment	@abandonment\n- (Tech) bỏ, từ bỏ (d)
abase	@abase /ə'beis/\n*  ngoại động từ\n- làm hạ phẩm giá, làm mất thể diện, làm nhục\n=to abase one-self+ tự hạ mình
abasement	@abasement /ə'beismənt/\n*  danh từ\n- sự làm hạ phẩm giá, sự làm mất thể diện, sự làm nhục
abash	@abash /ə'bæʃ/\n*  ngoại động từ\n- làm bối rối, làm lúng túng, làm luống cuống
abashed	@abashed\n* tính từ\n- bối rối, xấu hổ
abashment	@abashment /ə'bæʃmənt/\n*  danh từ\n- sự bối rối, sự lúng túng, sự luống cuống
abasia	* danh từ\n- (y học) chứng thất hành, không đi lại được
abatable	@abatable /ə'beitəbl/\n*  tính từ\n- có thể làm dịu, có thể làm yếu đi, có thể giảm bớt\n- có thể hạ, có thể bớt\n- có thể làm nhụt\n- có thể chấm dứt, có thể thanh trừ\n- (pháp lý) có thể huỷ bỏ, có thể thủ tiêu
abate	@abate /ə'beit/\n*  ngoại động từ\n- làm dịu đi, làm yếu đi, làm giảm bớt\n=to abate a pain+ làm dịu đau\n- hạ (giá), bớt (giá)\n- làm nhụt (nhụt khí...)\n- làm cùn (lưỡi dao...)\n- thanh toán, làm mất hết (những điều khó chịu, bực bội)\n- (pháp lý) huỷ bỏ, thủ tiêu\n- (kỹ thuật) ram (thép)\n*  nội động từ\n- dịu đi, yếu đi, nhụt đi, đỡ, bớt, ngớt\n=paint abates+ cơn đau dịu đi\n=storm abates+ cơn bão ngớt\n@Chuyên ngành kinh tế\n-giảm giá\n@Chuyên ngành kỹ thuật\n-giảm\n-giảm đi\n-giảm giá\n-hủy bỏ\n-ram\n@Lĩnh vực: cơ khí & công trình\n-ram (thép)\n@Lĩnh vực: giao thông & vận tải\n-xấu đi (thời tiết)\n-yếu đi (gió)
abatement	@abatement /ə'beitmənt/\n*  danh từ\n- sự dịu đi, sự yếu đi, sự nhụt đi, sự giảm bớt, sự đỡ, sự ngớt\n- sự hạ (giá), sự bớt (giá)\n- sự chấm dứt, sự thanh toán\n- (pháp lý) sự huỷ bỏ, sự thủ tiêu\n=abatement of a contract+ sự huỷ bỏ một hợp đồng\n@Chuyên ngành kinh tế\n-bớt giá\n-đình chỉ\n-giảm giá\n-hủy bỏ\n-sự giảm giá\n-sự tiêu trừ\n@Chuyên ngành kỹ thuật\n-mất mát\n-phế liệu\n-sự giảm bớt\n-sự hạ xuống\n-sự thanh toán\n@Lĩnh vực: xây dựng\n-sự dịu đi\n-sự giảm yếu\n@Lĩnh vực: y học\n-sự giãn đau
abater	@abater\n* danh từ\n- người giảm bớt\n- (y học) thuốc làm dịu
abatis	@abatis /'æbətis/\n*  danh từ,  số nhiều abatis\n- (quân sự) đống cây chướng ngại, đống cây cản\n@Chuyên ngành kinh tế\n-vật cản\n-vật chướng ngại\n@Chuyên ngành kỹ thuật\n@Lĩnh vực: xây dựng\n-giá gỗ tam giác
abattoir	@abattoir /'æbətwɑ:/\n*  danh từ\n- lò mổ, lò sát sinh\n@Chuyên ngành kinh tế\n-lò mổ
abaxial	@abaxial\n* tính từ\n- ở ngoài trục, xa trục\n@Chuyên ngành kỹ thuật\n-lệch trục\n@Lĩnh vực: y học\n-xa trục
abbacy	@abbacy /'æbəsi/\n*  danh từ\n- chức vị trưởng tu viện; quyền hạn trưởng tu viện
abbatial	@abbatial /ə'beiʃəl/\n*  tính từ\n- (thuộc) trưởng tu viện
abbess	@abbess /'æbis/\n*  danh từ\n- bà trưởng tu viện
abbey	@abbey /'æbi/\n*  danh từ\n- tu viện\n- giới tu sĩ, các nhà tu, các bà xơ nhà thờ (lớn)\n@Chuyên ngành kỹ thuật\n-tu viện\n@Lĩnh vực: xây dựng\n-nhà thờ (lớn)
abbot	@abbot /'æbət/\n*  danh từ\n- cha trưởng tu viện
abbreviate	@abbreviate /ə'bri:vieit/\n*  ngoại động từ\n- tóm tắt, viết tắt; rút ngắn lại (cuộc đi thăm...)\n- (toán học) ước lược, rút gọn\n*  tính từ\n- tương đối ngắn\n@Chuyên ngành kỹ thuật\n-rút gọn\n-rút ngắn\n-viết tắt\n@Lĩnh vực: toán & tin\n-viết gọn
abbreviate	@abbreviate\n- (Tech) rút gọn; viết tắt
abbreviated	@abbreviated /ə'bri:vietid/\n*  tính từ\n- tóm tắt; viết tắt; rút ngắn lại\n- ngắn cũn cỡn (quần áo...)\n@Chuyên ngành kỹ thuật\n@Lĩnh vực: toán & tin\n-được rút gọn\n-được viết tắt\n-rút ngắn lại
abbreviation	@abbreviation /ə,bri:vi'eiʃn/\n*  danh từ\n- sự tóm tắt, sự rút ngắn (cuộc đi thăm...)\n- bài tóm tắt\n- chữ viết tắt\n=Jan is the abbreviation January+ Jan là chữ viết tắt của January\n- (toán học) sự ước lược, sự rút gọn\n@Chuyên ngành kinh tế\n-sự rút ngắn\n-viết tắt\n@Chuyên ngành kỹ thuật\n-chữ tắt\n-lược ký\n-lược tự\n-sự rút gọn\n-sự rút ngắn\n@Lĩnh vực: toán & tin\n-chữ viết tắt\n-sự viết gọn\n-sự viết tắt
abbreviation	@abbreviation\n- sự viết gọn, sự viết tắt
abbreviations	@Chuyên ngành kỹ thuật\n@Lĩnh vực: điện\n-những chữ viết tắt
abbreviator	@abbreviator /ə'bri:vieitə/\n*  danh từ\n- người tóm tắt
abdicable	@abdicable\n- xem abdicate
abdicate	@abdicate /'æbdikeit/\n*  ngoại động từ\n- từ bỏ (quyền lợi, địa vị...)\n=to abdicate a position+ từ bỏ một địa vị\n=to abdicate all one's rights+ từ bỏ mọi quyền lợi\n*  nội động từ\n- thoái vị, từ ngôi
abdication	@abdication /,æbdi'keiʃn/\n*  danh từ\n- sự thoái vị, sự từ ngôi\n- sự từ bỏ (địa vị, chức vụ, quyền lợi...)
abdicator	@abdicator /'æbdikeitə/ (abdicant) /'æbdikənt/\n*  danh từ\n- người từ bỏ\n- người thoái vị
abdomen	@abdomen /'æbdəmen/\n*  danh từ\n- bụng\n@Chuyên ngành kinh tế\n-bụng\n@Chuyên ngành kỹ thuật\n-bụng
abdominal	@abdominal /æb'dɔminl/\n*  tính từ\n- (thuộc) bụng; ở bụng\n=an abdominal operation+ phẫu thuật ở bụng\n=abdominal cavity+ khoang bụng\n@Chuyên ngành kinh tế\n-bụng\n@Chuyên ngành kỹ thuật\n@Lĩnh vực: y học\n-mạc bụng
abdominally	@abdominally\n* phó từ\n- (thuộc) bụng; ở bụng
abducens	@abducens\n* danh từ\n- dây thần kinh não VI ra ngoài
abducent	@abducent /æb'dju:sənt/\n*  tính từ\n- (giải phẫu) rẽ ra, giạng ra
abduct	@abduct /æd'dʌkt/\n*  ngoại động từ\n- bắt cóc, cuỗm đi, lừa đem đi (người đàn bà...)\n- (giải phẫu) rẽ ra, giạng ra
abduction	@abduction /æb'dʌkʃn/\n*  danh từ\n- sự bắt cóc (trẻ em...), sự bắt đi, sự cuỗm đi, sự lừa đem đi\n- (giải phẫu) sự giạng ra\n@Chuyên ngành kỹ thuật\n-sự giạng ra
abductor	@abductor /æb'dʌktə/\n*  danh từ\n- người bắt cóc, người cuỗm đi, người lừa đem đi\n- (giải phẫu) cơ giạng ((cũng) abductor muscle)
abeam	@abeam /ə'bi:m/\n*  phó từ\n- (hàng hải),  (hàng không) đâm ngang sườn\n=abeam of us+ ngang sườn chúng tôi; sóng ngang với chúng tôi\n@Chuyên ngành kỹ thuật\n-ngang sườn\n-ngang sườn tầu\n-ngang tia dẫn hướng
abecedarian	@abecedarian /,eibi:si:'deəriən/\n*  tính từ\n- sắp xếp theo thứ tự abc\n- sơ đẳng\n- dốt nát\n*  danh từ\n- (từ Mỹ,nghĩa Mỹ) học sinh vỡ lòng
abed	@abed /ə'bed/\n*  phó từ\n- ở trên giường\n=to lie abed+ nằm ở trên giường
abele	@abele /ə'bi:l/\n*  danh từ\n- (thực vật học) cây bạch dương
abelmosk	@abelmosk /'eibəlmɔsk/\n*  danh từ\n- (thực vật học) cây vông vàng
aberrance	@aberrance /æ'berəns/ (aberrancy) /æ'berənsi/\n*  danh từ\n- sự lầm lạc\n- (sinh vật học) sự khác thường
aberrancy	@aberrancy /æ'berəns/ (aberrancy) /æ'berənsi/\n*  danh từ\n- sự lầm lạc\n- (sinh vật học) sự khác thường
aberrant	@aberrant /æ'berənt/\n*  tính từ\n- lầm lạc\n- (sinh vật học) khác thường
aberrantly	@aberrantly\n- xem aberrant
aberration	@aberration /æ'be'reiʃn/\n*  danh từ\n- sự lầm lạc; phút lầm lạc\n- sự kém trí khôn, sự loạn trí\n- sự khác thường\n- (vật lý) quang sai\n=lateral aberration+ quang sai ngang\n- (thiên văn học) tính sai\n=secular aberration+ tính sai trường kỳ\n=annual aberration+ tính sai hằng năm\n@Chuyên ngành kỹ thuật\n-độ lệch\n-sắc sai\n-sự biến hình\n-sự sai lệch\n-tinh sai\n@Lĩnh vực: y học\n-quang sai\n-sự sai hình\n-sự sai trệch\n@Lĩnh vực: xây dựng\n-sự méo hình\n@Lĩnh vực: điện tử & viễn thông\n-sự quang sai
abet	@abet /ə'bet/\n*  ngoại động từ\n- xúi bẩy, xúi giục, khích\n- tiếp tay (ai làm bậy)
abetment	@abetment /ə'betmənt/ (abettal) /ə'betəl/\n*  danh từ\n- sự xúi bẩy, sự xúi giục, sự khích\n- sự tiếp tay
abettal	@abettal /ə'betmənt/ (abettal) /ə'betəl/\n*  danh từ\n- sự xúi bẩy, sự xúi giục, sự khích\n- sự tiếp tay
abetter	@abetter\n* danh từ\n- kẻ xúi giục\n- kẻ tiếp tay
abettor	@abettor /ə'betə/ (abettor) /ə'betə/\n*  danh từ\n- kẻ xúi giục\n- kẻ tiếp tay
abeyance	@abeyance /ə'beiəns/\n*  danh từ\n- sự đọng lại\n=work in abeyance+ công việc còn đọng lại\n- sự đình chỉ, sự hoãn lại, sự tạm thời không áp dụng (đạo luật...)\n=to be in abeyance; to fall into abeyance+ bị đình chỉ, bị hoãn lại, tạm thời không được áp dụng\n- (pháp lý) tình trạng tạm thời không có người nhận; tình trạng tạm thời vô chủ\n=lands in abeyance+ đất vô thừa nhận, đất vô chủ\n- tình trạng trống, tình trạng khuyết (một chức vị)\n@Chuyên ngành kinh tế\n-đình chỉ\n-sự bỏ xó\n@Chuyên ngành kỹ thuật\n@Lĩnh vực: y học\n-sự ngừng hoạt động
abeyant	@abeyant /ə'beiənt/\n*  tính từ\n- tạm thời đình chỉ, tạm nghỉ hoạt động
abfarad	@Chuyên ngành kỹ thuật\n@Lĩnh vực: điện lạnh\n-aF (fara hệ CGS điện từ, bằng 10 mũ 9 fara)\n-fara hệ từ
abhenry	@Chuyên ngành kỹ thuật\n@Lĩnh vực: điện lạnh\n-henry hệ từ
abhor	@abhor /əb'hɔ:/\n*  ngoại động từ\n- ghê tởm; ghét cay ghét đắng
abhorrence	@abhorrence /əb'hɔrəns/\n*  danh từ\n- sự ghê tởm\n=to have an abhorrence of+ sự ghét cay ghét đắng\n=to hold in abhorrence of+ ghê tởm; ghét cay ghét đắng\n- điều ghê tởm; cái bị ghét cay ghét đắng
abhorrent	@abhorrent /əb'hɔrənt/\n*  tính từ\n- ghê tởm, đáng ghét\n=to be abhorrent to someone+ ghê tởm đối với ai, bị ai ghê tởm, bị ai ghét cay ghét đắng\n- (+ from) trái với, mâu thuẫn với, không hợp với\n=conduct abhorrent from principles+ tư cách mâu thuẫn với phép tắc\n- (từ cổ,nghĩa cổ) (+ of) ghê tởm, ghét cay ghét đắng\n=to be abhorrent of something+ ghê tởm cái gì, ghét cay ghét đắng cái gì
abhorrently	@abhorrently\n- xem abhorrent
